Word	VAD.tiny.test
adjoining	VAD.tiny.test
affirmatively	VAD.tiny.test
captivate	VAD.tiny.test
catching	VAD.tiny.test
chimpanzee	VAD.tiny.test
clubs	VAD.tiny.test
convent	VAD.tiny.test
crumb	VAD.tiny.test
drinker	VAD.tiny.test
happily	VAD.tiny.test
honest	VAD.tiny.test
hydraulic	VAD.tiny.test
importance	VAD.tiny.test
jazz	VAD.tiny.test
neatly	VAD.tiny.test
philanthropist	VAD.tiny.test
pusher	VAD.tiny.test
regency	VAD.tiny.test
shuffleboard	VAD.tiny.test
studio	VAD.tiny.test
substitution	VAD.tiny.test
sunk	VAD.tiny.test
thatmoment	VAD.tiny.test
Word	VAD.tiny.train
abdominal	VAD.tiny.train
abnormality	VAD.tiny.train
aerodrome	VAD.tiny.train
affectionate	VAD.tiny.train
afternoon	VAD.tiny.train
aghhh	VAD.tiny.train
alibi	VAD.tiny.train
allure	VAD.tiny.train
anguish	VAD.tiny.train
ascertained	VAD.tiny.train
assistance	VAD.tiny.train
asunder	VAD.tiny.train
atpeace	VAD.tiny.train
automated	VAD.tiny.train
bash	VAD.tiny.train
beneficial	VAD.tiny.train
birthright	VAD.tiny.train
blatant	VAD.tiny.train
bonbon	VAD.tiny.train
breach	VAD.tiny.train
breakup	VAD.tiny.train
breeze	VAD.tiny.train
broomstick	VAD.tiny.train
candor	VAD.tiny.train
candy	VAD.tiny.train
capable	VAD.tiny.train
cassette	VAD.tiny.train
centrally	VAD.tiny.train
charisma	VAD.tiny.train
charity	VAD.tiny.train
cheerful	VAD.tiny.train
civic	VAD.tiny.train
cleave	VAD.tiny.train
coax	VAD.tiny.train
codeine	VAD.tiny.train
coincidental	VAD.tiny.train
consecutive	VAD.tiny.train
continuity	VAD.tiny.train
contracted	VAD.tiny.train
cotton	VAD.tiny.train
counts	VAD.tiny.train
cute	VAD.tiny.train
defending	VAD.tiny.train
denied	VAD.tiny.train
disclaimer	VAD.tiny.train
dive	VAD.tiny.train
ecosystem	VAD.tiny.train
editorial	VAD.tiny.train
effect	VAD.tiny.train
engraved	VAD.tiny.train
entire	VAD.tiny.train
esquire	VAD.tiny.train
exhumation	VAD.tiny.train
fascinate	VAD.tiny.train
feelinggood	VAD.tiny.train
flexion	VAD.tiny.train
forlorn	VAD.tiny.train
formed	VAD.tiny.train
fryer	VAD.tiny.train
galled	VAD.tiny.train
geology	VAD.tiny.train
gifts	VAD.tiny.train
gills	VAD.tiny.train
glaucoma	VAD.tiny.train
glazed	VAD.tiny.train
goodmorning	VAD.tiny.train
gratis	VAD.tiny.train
greatest	VAD.tiny.train
habitation	VAD.tiny.train
hall	VAD.tiny.train
harbor	VAD.tiny.train
hazmat	VAD.tiny.train
healing	VAD.tiny.train
hero	VAD.tiny.train
hobo	VAD.tiny.train
hum	VAD.tiny.train
hypothermia	VAD.tiny.train
impartial	VAD.tiny.train
impassioned	VAD.tiny.train
infamous	VAD.tiny.train
instrumentalist	VAD.tiny.train
intercede	VAD.tiny.train
intercept	VAD.tiny.train
inversion	VAD.tiny.train
iron	VAD.tiny.train
jiggle	VAD.tiny.train
laptop	VAD.tiny.train
lettuce	VAD.tiny.train
libel	VAD.tiny.train
magistrate	VAD.tiny.train
malnutrition	VAD.tiny.train
mama	VAD.tiny.train
merit	VAD.tiny.train
minded	VAD.tiny.train
mislead	VAD.tiny.train
mismatched	VAD.tiny.train
mote	VAD.tiny.train
mystic	VAD.tiny.train
newscaster	VAD.tiny.train
ocean	VAD.tiny.train
oestrogen	VAD.tiny.train
opener	VAD.tiny.train
orb	VAD.tiny.train
organist	VAD.tiny.train
outback	VAD.tiny.train
overpriced	VAD.tiny.train
overthinking	VAD.tiny.train
paddy	VAD.tiny.train
paltry	VAD.tiny.train
patriotic	VAD.tiny.train
perceive	VAD.tiny.train
perishing	VAD.tiny.train
perspective	VAD.tiny.train
physical therapist	VAD.tiny.train
plentiful	VAD.tiny.train
pontoon	VAD.tiny.train
positively	VAD.tiny.train
pot	VAD.tiny.train
potency	VAD.tiny.train
predict	VAD.tiny.train
prejudicial	VAD.tiny.train
prepared	VAD.tiny.train
prevail	VAD.tiny.train
projectile	VAD.tiny.train
prop	VAD.tiny.train
prosecute	VAD.tiny.train
psychiatric	VAD.tiny.train
pubic	VAD.tiny.train
push	VAD.tiny.train
queasy	VAD.tiny.train
reconnect	VAD.tiny.train
recruiter	VAD.tiny.train
refrigerator	VAD.tiny.train
required	VAD.tiny.train
resigned	VAD.tiny.train
rewire	VAD.tiny.train
rope	VAD.tiny.train
ruff	VAD.tiny.train
sandpaper	VAD.tiny.train
sausage	VAD.tiny.train
scion	VAD.tiny.train
sculptor	VAD.tiny.train
send	VAD.tiny.train
shitday	VAD.tiny.train
shrivel	VAD.tiny.train
sideburns	VAD.tiny.train
silliness	VAD.tiny.train
simplistic	VAD.tiny.train
sneaky	VAD.tiny.train
speckled	VAD.tiny.train
sterling	VAD.tiny.train
stfu	VAD.tiny.train
stocking	VAD.tiny.train
strapless	VAD.tiny.train
summerhouse	VAD.tiny.train
survival	VAD.tiny.train
tense	VAD.tiny.train
terrorize	VAD.tiny.train
therapy	VAD.tiny.train
thermal	VAD.tiny.train
thirteen	VAD.tiny.train
thud	VAD.tiny.train
tickle	VAD.tiny.train
tightness	VAD.tiny.train
transcendental	VAD.tiny.train
translator	VAD.tiny.train
transparent	VAD.tiny.train
triad	VAD.tiny.train
turbo	VAD.tiny.train
twister	VAD.tiny.train
ugly	VAD.tiny.train
uncommonly	VAD.tiny.train
underage	VAD.tiny.train
unencumbered	VAD.tiny.train
unflinching	VAD.tiny.train
unhook	VAD.tiny.train
unitary	VAD.tiny.train
unutterable	VAD.tiny.train
validity	VAD.tiny.train
vampire	VAD.tiny.train
vary	VAD.tiny.train
velvety	VAD.tiny.train
yousuck	VAD.tiny.train
Word	VAD.tiny.val
accessory	VAD.tiny.val
adipose	VAD.tiny.val
cave	VAD.tiny.val
ceramics	VAD.tiny.val
cilantro	VAD.tiny.val
coherence	VAD.tiny.val
credentials	VAD.tiny.val
daybreak	VAD.tiny.val
dustpan	VAD.tiny.val
hairdryer	VAD.tiny.val
hillside	VAD.tiny.val
hurl	VAD.tiny.val
implication	VAD.tiny.val
irrigate	VAD.tiny.val
musk	VAD.tiny.val
plunge	VAD.tiny.val
recruiting	VAD.tiny.val
residence	VAD.tiny.val
shorten	VAD.tiny.val
sugar	VAD.tiny.val
superficial	VAD.tiny.val
suspension	VAD.tiny.val
timid	VAD.tiny.val
