Word	VAD.small.test
aaaaaaah	VAD.small.test
adjoining	VAD.small.test
affirmatively	VAD.small.test
afire	VAD.small.test
anal	VAD.small.test
anatomy	VAD.small.test
anecdote	VAD.small.test
antique	VAD.small.test
approbation	VAD.small.test
aspire	VAD.small.test
assertive	VAD.small.test
attentive	VAD.small.test
attest	VAD.small.test
avenging	VAD.small.test
averse	VAD.small.test
backup	VAD.small.test
balm	VAD.small.test
bawl	VAD.small.test
bees	VAD.small.test
bellboy	VAD.small.test
bide	VAD.small.test
bitty	VAD.small.test
bleep	VAD.small.test
bookkeeping	VAD.small.test
boxer	VAD.small.test
buffoon	VAD.small.test
buildup	VAD.small.test
bulky	VAD.small.test
bumper	VAD.small.test
captivate	VAD.small.test
catching	VAD.small.test
character	VAD.small.test
charming	VAD.small.test
chimpanzee	VAD.small.test
cleanse	VAD.small.test
clubs	VAD.small.test
cocoa	VAD.small.test
cod	VAD.small.test
cognition	VAD.small.test
colt	VAD.small.test
combinatorial	VAD.small.test
commerce	VAD.small.test
condolence	VAD.small.test
confound	VAD.small.test
consignee	VAD.small.test
convent	VAD.small.test
cooperating	VAD.small.test
copyright	VAD.small.test
cortex	VAD.small.test
cosy	VAD.small.test
credit	VAD.small.test
creed	VAD.small.test
cremation	VAD.small.test
crumb	VAD.small.test
crystalline	VAD.small.test
culminate	VAD.small.test
daiquiri	VAD.small.test
dependency	VAD.small.test
desert	VAD.small.test
designation	VAD.small.test
desolate	VAD.small.test
difficulty	VAD.small.test
discovery	VAD.small.test
downward	VAD.small.test
drinker	VAD.small.test
elimination	VAD.small.test
enlarged	VAD.small.test
epitaph	VAD.small.test
excruciating	VAD.small.test
extended	VAD.small.test
female	VAD.small.test
flan	VAD.small.test
flaunt	VAD.small.test
flighty	VAD.small.test
fret	VAD.small.test
fringe	VAD.small.test
gamble	VAD.small.test
gauze	VAD.small.test
germ	VAD.small.test
glitch	VAD.small.test
goat	VAD.small.test
goggle	VAD.small.test
gospel	VAD.small.test
halo	VAD.small.test
happily	VAD.small.test
harassment	VAD.small.test
headlock	VAD.small.test
hemp	VAD.small.test
homeopathic	VAD.small.test
honest	VAD.small.test
horrendous	VAD.small.test
hourglass	VAD.small.test
hydraulic	VAD.small.test
hydraulics	VAD.small.test
hysterical	VAD.small.test
importance	VAD.small.test
indentation	VAD.small.test
inflation	VAD.small.test
instinct	VAD.small.test
intentional	VAD.small.test
invisibility	VAD.small.test
itinerant	VAD.small.test
jack	VAD.small.test
jazz	VAD.small.test
jiff	VAD.small.test
journalist	VAD.small.test
kiddo	VAD.small.test
klutz	VAD.small.test
knockout	VAD.small.test
kryptonite	VAD.small.test
lace	VAD.small.test
landing	VAD.small.test
lanky	VAD.small.test
larder	VAD.small.test
lay	VAD.small.test
layered	VAD.small.test
leaf	VAD.small.test
leaflet	VAD.small.test
leeches	VAD.small.test
less	VAD.small.test
liable	VAD.small.test
lights	VAD.small.test
lunacy	VAD.small.test
mare	VAD.small.test
menopause	VAD.small.test
moderate	VAD.small.test
muddy	VAD.small.test
nap	VAD.small.test
neatly	VAD.small.test
needit	VAD.small.test
negligent	VAD.small.test
nip	VAD.small.test
nun	VAD.small.test
oneself	VAD.small.test
ordeal	VAD.small.test
outrage	VAD.small.test
pansy	VAD.small.test
panther	VAD.small.test
part	VAD.small.test
pavilion	VAD.small.test
payer	VAD.small.test
penultimate	VAD.small.test
perforated	VAD.small.test
permeate	VAD.small.test
philanthropist	VAD.small.test
photographer	VAD.small.test
plumbing	VAD.small.test
polo	VAD.small.test
poop	VAD.small.test
potted	VAD.small.test
prelim	VAD.small.test
propelling	VAD.small.test
pusher	VAD.small.test
quartered	VAD.small.test
rampage	VAD.small.test
reclining	VAD.small.test
redemption	VAD.small.test
reflex	VAD.small.test
regency	VAD.small.test
relevance	VAD.small.test
renovated	VAD.small.test
rescission	VAD.small.test
respectability	VAD.small.test
retain	VAD.small.test
rising	VAD.small.test
salon	VAD.small.test
scold	VAD.small.test
secretary	VAD.small.test
sentinel	VAD.small.test
sewage	VAD.small.test
shuddering	VAD.small.test
shuffleboard	VAD.small.test
sickness	VAD.small.test
simples	VAD.small.test
simultaneously	VAD.small.test
ska	VAD.small.test
slander	VAD.small.test
spectrometer	VAD.small.test
speed	VAD.small.test
studio	VAD.small.test
substitute	VAD.small.test
substitution	VAD.small.test
subversive	VAD.small.test
sundae	VAD.small.test
sunk	VAD.small.test
suppose	VAD.small.test
swordfish	VAD.small.test
tableware	VAD.small.test
teeth	VAD.small.test
tepid	VAD.small.test
terrifies	VAD.small.test
thatmoment	VAD.small.test
toll	VAD.small.test
tracing	VAD.small.test
translation	VAD.small.test
try	VAD.small.test
tweezers	VAD.small.test
twelfth	VAD.small.test
unbecoming	VAD.small.test
unfollow	VAD.small.test
unmatched	VAD.small.test
untrue	VAD.small.test
vane	VAD.small.test
wander	VAD.small.test
welcoming	VAD.small.test
wildebeest	VAD.small.test
woe	VAD.small.test
Word	VAD.small.train
aaaah	VAD.small.train
abdominal	VAD.small.train
abnormality	VAD.small.train
aboard	VAD.small.train
abstain	VAD.small.train
absurd	VAD.small.train
absurdity	VAD.small.train
accelerator	VAD.small.train
accident	VAD.small.train
accord	VAD.small.train
accordion	VAD.small.train
accuracy	VAD.small.train
accurate	VAD.small.train
accused	VAD.small.train
accustomed	VAD.small.train
achieved	VAD.small.train
acquaint	VAD.small.train
actionable	VAD.small.train
activity	VAD.small.train
acumen	VAD.small.train
adapt	VAD.small.train
additive	VAD.small.train
adjacency	VAD.small.train
admiralty	VAD.small.train
admixture	VAD.small.train
adulterated	VAD.small.train
adulthood	VAD.small.train
advance	VAD.small.train
advantageous	VAD.small.train
aerodrome	VAD.small.train
affectionate	VAD.small.train
affordable	VAD.small.train
affronted	VAD.small.train
afternoon	VAD.small.train
aggresive	VAD.small.train
aghhh	VAD.small.train
agitate	VAD.small.train
agitated	VAD.small.train
agnostic	VAD.small.train
agriculture	VAD.small.train
ahoy	VAD.small.train
aim	VAD.small.train
airship	VAD.small.train
ait	VAD.small.train
alarm clock	VAD.small.train
alibi	VAD.small.train
alignment	VAD.small.train
alimentation	VAD.small.train
alleged	VAD.small.train
allegory	VAD.small.train
allot	VAD.small.train
allow	VAD.small.train
allowance	VAD.small.train
allure	VAD.small.train
allusion	VAD.small.train
ally	VAD.small.train
aloof	VAD.small.train
ameliorate	VAD.small.train
amendment	VAD.small.train
amends	VAD.small.train
amenity	VAD.small.train
amour	VAD.small.train
amputation	VAD.small.train
angiogram	VAD.small.train
anguish	VAD.small.train
anonymity	VAD.small.train
antibiotics	VAD.small.train
antipathy	VAD.small.train
aorta	VAD.small.train
aperture	VAD.small.train
appendectomy	VAD.small.train
appreciative	VAD.small.train
apprehend	VAD.small.train
apprentice	VAD.small.train
archbishop	VAD.small.train
archer	VAD.small.train
areyoukidding	VAD.small.train
argumentative	VAD.small.train
arithmetic	VAD.small.train
arm	VAD.small.train
armada	VAD.small.train
armed	VAD.small.train
armor	VAD.small.train
ascend	VAD.small.train
ascertained	VAD.small.train
ash	VAD.small.train
aspen	VAD.small.train
assassinate	VAD.small.train
assignment	VAD.small.train
assistance	VAD.small.train
assumption	VAD.small.train
asthmatic	VAD.small.train
asunder	VAD.small.train
asylum	VAD.small.train
atelier	VAD.small.train
atpeace	VAD.small.train
attainment	VAD.small.train
attenuation	VAD.small.train
audition	VAD.small.train
auditory	VAD.small.train
authoritative	VAD.small.train
autistic	VAD.small.train
auto	VAD.small.train
automated	VAD.small.train
autumn	VAD.small.train
avarice	VAD.small.train
average	VAD.small.train
aviator	VAD.small.train
await	VAD.small.train
awe	VAD.small.train
awed	VAD.small.train
awestruck	VAD.small.train
awful	VAD.small.train
awkward	VAD.small.train
awry	VAD.small.train
axe	VAD.small.train
axial	VAD.small.train
axiom	VAD.small.train
ay	VAD.small.train
baby	VAD.small.train
baccarat	VAD.small.train
background	VAD.small.train
badger	VAD.small.train
balanced	VAD.small.train
ballroom	VAD.small.train
banter	VAD.small.train
barman	VAD.small.train
barrow	VAD.small.train
bash	VAD.small.train
bass	VAD.small.train
bastarding	VAD.small.train
bath	VAD.small.train
batter	VAD.small.train
bayonet	VAD.small.train
beading	VAD.small.train
beanie	VAD.small.train
become	VAD.small.train
bed	VAD.small.train
bee	VAD.small.train
begging	VAD.small.train
beginner	VAD.small.train
belief	VAD.small.train
believer	VAD.small.train
bellow	VAD.small.train
beneficial	VAD.small.train
benevolence	VAD.small.train
betrothed	VAD.small.train
bewilderment	VAD.small.train
biblical	VAD.small.train
bickering	VAD.small.train
bilayer	VAD.small.train
biochemistry	VAD.small.train
birthright	VAD.small.train
bison	VAD.small.train
bitterness	VAD.small.train
blackmailer	VAD.small.train
blame	VAD.small.train
blare	VAD.small.train
blatant	VAD.small.train
blender	VAD.small.train
bleu	VAD.small.train
blinding	VAD.small.train
blindly	VAD.small.train
bloat	VAD.small.train
bloom	VAD.small.train
blunder	VAD.small.train
boastful	VAD.small.train
bobsled	VAD.small.train
bogeyman	VAD.small.train
boisterous	VAD.small.train
bombshell	VAD.small.train
bonbon	VAD.small.train
bondage	VAD.small.train
bonne	VAD.small.train
bonny	VAD.small.train
book	VAD.small.train
bookmark	VAD.small.train
bowed	VAD.small.train
bowels	VAD.small.train
breach	VAD.small.train
breakthrough	VAD.small.train
breakup	VAD.small.train
breast	VAD.small.train
breed	VAD.small.train
breeze	VAD.small.train
briar	VAD.small.train
brigade	VAD.small.train
brilliance	VAD.small.train
broke	VAD.small.train
brokenheart	VAD.small.train
bronze	VAD.small.train
broomstick	VAD.small.train
bucko	VAD.small.train
buffer	VAD.small.train
buildings	VAD.small.train
bullshit	VAD.small.train
bundle	VAD.small.train
bungee	VAD.small.train
buoyancy	VAD.small.train
burial	VAD.small.train
burner	VAD.small.train
bus	VAD.small.train
busybody	VAD.small.train
cabriolet	VAD.small.train
cage	VAD.small.train
calender	VAD.small.train
callback	VAD.small.train
camouflage	VAD.small.train
camouflaged	VAD.small.train
campus	VAD.small.train
canal	VAD.small.train
candidacy	VAD.small.train
candor	VAD.small.train
candy	VAD.small.train
cap	VAD.small.train
capable	VAD.small.train
capitulation	VAD.small.train
carpool	VAD.small.train
carrot	VAD.small.train
carve	VAD.small.train
carver	VAD.small.train
casket	VAD.small.train
casserole	VAD.small.train
cassette	VAD.small.train
caste	VAD.small.train
castor	VAD.small.train
catalog	VAD.small.train
catchy	VAD.small.train
catnip	VAD.small.train
caution	VAD.small.train
caveat	VAD.small.train
caviar	VAD.small.train
cedar	VAD.small.train
celery	VAD.small.train
centrally	VAD.small.train
cereal	VAD.small.train
chaos	VAD.small.train
chapter	VAD.small.train
chargeable	VAD.small.train
charisma	VAD.small.train
charity	VAD.small.train
cheap	VAD.small.train
cheat	VAD.small.train
cheerful	VAD.small.train
cheers	VAD.small.train
chevron	VAD.small.train
chiefly	VAD.small.train
childish	VAD.small.train
childless	VAD.small.train
chirping	VAD.small.train
chrome	VAD.small.train
chromosome	VAD.small.train
chug	VAD.small.train
cinder	VAD.small.train
cirrhosis	VAD.small.train
citadel	VAD.small.train
civic	VAD.small.train
clarinet	VAD.small.train
classified	VAD.small.train
cleansing	VAD.small.train
cleave	VAD.small.train
cleaver	VAD.small.train
clench	VAD.small.train
clip	VAD.small.train
clipboard	VAD.small.train
clipping	VAD.small.train
clitoris	VAD.small.train
clockwork	VAD.small.train
coating	VAD.small.train
coax	VAD.small.train
cobalt	VAD.small.train
codeine	VAD.small.train
coffee table	VAD.small.train
coffin	VAD.small.train
cohesion	VAD.small.train
coincident	VAD.small.train
coincidental	VAD.small.train
cold	VAD.small.train
collapse	VAD.small.train
colleague	VAD.small.train
colonial	VAD.small.train
colored	VAD.small.train
colossal	VAD.small.train
comb	VAD.small.train
comforting	VAD.small.train
commemorate	VAD.small.train
commemoration	VAD.small.train
commercial	VAD.small.train
commissary	VAD.small.train
commissioner	VAD.small.train
communicative	VAD.small.train
communicator	VAD.small.train
commute	VAD.small.train
compassion	VAD.small.train
compelled	VAD.small.train
competent	VAD.small.train
completing	VAD.small.train
complexity	VAD.small.train
complicated	VAD.small.train
comply	VAD.small.train
comprehend	VAD.small.train
compressible	VAD.small.train
compulsory	VAD.small.train
concave	VAD.small.train
concessional	VAD.small.train
concomitant	VAD.small.train
condensed	VAD.small.train
conduit	VAD.small.train
confident	VAD.small.train
conformity	VAD.small.train
confounded	VAD.small.train
confusing	VAD.small.train
conga	VAD.small.train
congruence	VAD.small.train
conscription	VAD.small.train
consecutive	VAD.small.train
consequent	VAD.small.train
conserve	VAD.small.train
contemporaneous	VAD.small.train
contention	VAD.small.train
contentment	VAD.small.train
continual	VAD.small.train
continuation	VAD.small.train
continuity	VAD.small.train
continuum	VAD.small.train
contracted	VAD.small.train
contracting	VAD.small.train
contradiction	VAD.small.train
contradictory	VAD.small.train
conversational	VAD.small.train
converse	VAD.small.train
convertible	VAD.small.train
conveyancing	VAD.small.train
copacetic	VAD.small.train
copier	VAD.small.train
coping	VAD.small.train
cordon	VAD.small.train
cornball	VAD.small.train
cornflakes	VAD.small.train
costly	VAD.small.train
cotton	VAD.small.train
couch	VAD.small.train
counterpoint	VAD.small.train
countryman	VAD.small.train
counts	VAD.small.train
couple	VAD.small.train
courteous	VAD.small.train
cousins	VAD.small.train
coven	VAD.small.train
coveted	VAD.small.train
coward	VAD.small.train
cradle	VAD.small.train
crawfish	VAD.small.train
creation	VAD.small.train
creole	VAD.small.train
criticize	VAD.small.train
croquet	VAD.small.train
crummy	VAD.small.train
cubby	VAD.small.train
cube	VAD.small.train
cuddling	VAD.small.train
cue	VAD.small.train
cuisine	VAD.small.train
curb	VAD.small.train
cursed	VAD.small.train
cute	VAD.small.train
cuticle	VAD.small.train
cutthroat	VAD.small.train
daily	VAD.small.train
dairy	VAD.small.train
daisy	VAD.small.train
damsel	VAD.small.train
dapper	VAD.small.train
darling	VAD.small.train
dart	VAD.small.train
dash	VAD.small.train
deacon	VAD.small.train
deaf	VAD.small.train
dealership	VAD.small.train
debtor	VAD.small.train
deceptive	VAD.small.train
decomposed	VAD.small.train
decoration	VAD.small.train
decreased	VAD.small.train
decryption	VAD.small.train
defeated	VAD.small.train
defending	VAD.small.train
deferring	VAD.small.train
deficient	VAD.small.train
degenerate	VAD.small.train
delinquency	VAD.small.train
delirious	VAD.small.train
deliver	VAD.small.train
delude	VAD.small.train
demanding	VAD.small.train
demise	VAD.small.train
demonstrate	VAD.small.train
demonstration	VAD.small.train
demoralized	VAD.small.train
denied	VAD.small.train
dent	VAD.small.train
dentist	VAD.small.train
departed	VAD.small.train
dependable	VAD.small.train
dependence	VAD.small.train
deport	VAD.small.train
deposit	VAD.small.train
deposition	VAD.small.train
depresson	VAD.small.train
depth	VAD.small.train
deserter	VAD.small.train
desertion	VAD.small.train
destination	VAD.small.train
destroying	VAD.small.train
determinable	VAD.small.train
devastate	VAD.small.train
diatribe	VAD.small.train
dictatorial	VAD.small.train
dilatation	VAD.small.train
diluted	VAD.small.train
diminish	VAD.small.train
diocese	VAD.small.train
dioxide	VAD.small.train
diplomacy	VAD.small.train
dire	VAD.small.train
direction	VAD.small.train
directory	VAD.small.train
disappointing	VAD.small.train
disband	VAD.small.train
discards	VAD.small.train
discipline	VAD.small.train
disclaimer	VAD.small.train
disclosed	VAD.small.train
disclosure	VAD.small.train
discolored	VAD.small.train
disconnects	VAD.small.train
disembodied	VAD.small.train
disengage	VAD.small.train
dishonor	VAD.small.train
disinfect	VAD.small.train
dispense	VAD.small.train
displacement	VAD.small.train
disqualification	VAD.small.train
disruption	VAD.small.train
dissension	VAD.small.train
dissonance	VAD.small.train
distasteful	VAD.small.train
disused	VAD.small.train
diva	VAD.small.train
dive	VAD.small.train
divulge	VAD.small.train
docile	VAD.small.train
docking	VAD.small.train
doctor	VAD.small.train
dodge	VAD.small.train
doe	VAD.small.train
dogged	VAD.small.train
dollar	VAD.small.train
dome	VAD.small.train
domestication	VAD.small.train
domino	VAD.small.train
doubt	VAD.small.train
doubtful	VAD.small.train
draft	VAD.small.train
drake	VAD.small.train
drat	VAD.small.train
dreamy	VAD.small.train
drip	VAD.small.train
drizzle	VAD.small.train
drumming	VAD.small.train
dryness	VAD.small.train
duality	VAD.small.train
dubious	VAD.small.train
duffel	VAD.small.train
dumbasses	VAD.small.train
duo	VAD.small.train
duplex	VAD.small.train
duplication	VAD.small.train
duty	VAD.small.train
eagle	VAD.small.train
earpiece	VAD.small.train
earthquake	VAD.small.train
easel	VAD.small.train
eastbound	VAD.small.train
ecosystem	VAD.small.train
editorial	VAD.small.train
effect	VAD.small.train
efficacy	VAD.small.train
egomaniac	VAD.small.train
eighty	VAD.small.train
electric	VAD.small.train
electricity	VAD.small.train
elements	VAD.small.train
elevation	VAD.small.train
ellipsis	VAD.small.train
eloquent	VAD.small.train
embellish	VAD.small.train
embryonic	VAD.small.train
eminent	VAD.small.train
empathize	VAD.small.train
empire	VAD.small.train
empirical	VAD.small.train
empty	VAD.small.train
enablement	VAD.small.train
encompass	VAD.small.train
encore	VAD.small.train
encouraged	VAD.small.train
encyclopedia	VAD.small.train
endemic	VAD.small.train
endorsement	VAD.small.train
enforcement	VAD.small.train
engraved	VAD.small.train
enlargement	VAD.small.train
enlightened	VAD.small.train
entertainment	VAD.small.train
entire	VAD.small.train
envoy	VAD.small.train
epilepsy	VAD.small.train
episcopal	VAD.small.train
eradicate	VAD.small.train
eraser	VAD.small.train
errant	VAD.small.train
escalator	VAD.small.train
escort	VAD.small.train
esophagus	VAD.small.train
esquire	VAD.small.train
estimation	VAD.small.train
ethanol	VAD.small.train
ethic	VAD.small.train
ethnography	VAD.small.train
eulogium	VAD.small.train
evangelist	VAD.small.train
examiner	VAD.small.train
excitable	VAD.small.train
exhumation	VAD.small.train
existential	VAD.small.train
exit	VAD.small.train
exorcism	VAD.small.train
expectancy	VAD.small.train
experiences	VAD.small.train
expire	VAD.small.train
explode	VAD.small.train
exposed	VAD.small.train
expression	VAD.small.train
exquisite	VAD.small.train
extracurricular	VAD.small.train
extreme trust	VAD.small.train
eyeglass	VAD.small.train
facet	VAD.small.train
factor	VAD.small.train
faculty	VAD.small.train
fainting	VAD.small.train
fairly	VAD.small.train
familiar	VAD.small.train
familiarize	VAD.small.train
famous	VAD.small.train
fanaticism	VAD.small.train
fart	VAD.small.train
fascinate	VAD.small.train
fatherly	VAD.small.train
fathom	VAD.small.train
fawn	VAD.small.train
fearless	VAD.small.train
feasible	VAD.small.train
feathered	VAD.small.train
fed	VAD.small.train
feeble	VAD.small.train
feelinggood	VAD.small.train
feet	VAD.small.train
feign	VAD.small.train
feline	VAD.small.train
feminism	VAD.small.train
ferocious	VAD.small.train
ferret	VAD.small.train
fest	VAD.small.train
festival	VAD.small.train
fiancee	VAD.small.train
fibrosis	VAD.small.train
fight	VAD.small.train
fighter	VAD.small.train
filling	VAD.small.train
film	VAD.small.train
final	VAD.small.train
fiver	VAD.small.train
fixable	VAD.small.train
fizz	VAD.small.train
flabbergast	VAD.small.train
flame	VAD.small.train
flamethrower	VAD.small.train
flannel	VAD.small.train
flatten	VAD.small.train
flattering	VAD.small.train
flexion	VAD.small.train
flier	VAD.small.train
flooring	VAD.small.train
floozy	VAD.small.train
flounder	VAD.small.train
fluff	VAD.small.train
flurries	VAD.small.train
flyer	VAD.small.train
foal	VAD.small.train
fob	VAD.small.train
foe	VAD.small.train
foiled	VAD.small.train
food	VAD.small.train
foolhardy	VAD.small.train
foothold	VAD.small.train
footprint	VAD.small.train
footwork	VAD.small.train
forcibly	VAD.small.train
foreground	VAD.small.train
foresight	VAD.small.train
forlorn	VAD.small.train
format	VAD.small.train
formed	VAD.small.train
fortify	VAD.small.train
fortuitous	VAD.small.train
foursome	VAD.small.train
fragrance	VAD.small.train
frame	VAD.small.train
franchise	VAD.small.train
frank	VAD.small.train
freakish	VAD.small.train
freaky	VAD.small.train
freckle	VAD.small.train
freezer	VAD.small.train
fridge	VAD.small.train
friendship	VAD.small.train
frightened	VAD.small.train
frostbite	VAD.small.train
frosty	VAD.small.train
frothy	VAD.small.train
frugal	VAD.small.train
frustration	VAD.small.train
fryer	VAD.small.train
fuel	VAD.small.train
fumin	VAD.small.train
funnel	VAD.small.train
futility	VAD.small.train
futon	VAD.small.train
future	VAD.small.train
fuzz	VAD.small.train
gale	VAD.small.train
gallbladder	VAD.small.train
galled	VAD.small.train
gap	VAD.small.train
garb	VAD.small.train
gastronomy	VAD.small.train
gauging	VAD.small.train
gaze	VAD.small.train
genealogy	VAD.small.train
generalization	VAD.small.train
gentile	VAD.small.train
geology	VAD.small.train
germs	VAD.small.train
gifts	VAD.small.train
gills	VAD.small.train
gimp	VAD.small.train
gingerbread	VAD.small.train
gist	VAD.small.train
gland	VAD.small.train
glare	VAD.small.train
glass	VAD.small.train
glaucoma	VAD.small.train
glazed	VAD.small.train
glean	VAD.small.train
glorification	VAD.small.train
glossary	VAD.small.train
glum	VAD.small.train
gnome	VAD.small.train
goodday	VAD.small.train
goodmorning	VAD.small.train
goodmusic	VAD.small.train
gooood	VAD.small.train
gopher	VAD.small.train
gory	VAD.small.train
goulash	VAD.small.train
gracias	VAD.small.train
gracious	VAD.small.train
grade	VAD.small.train
grand	VAD.small.train
granny	VAD.small.train
grape juice	VAD.small.train
gratis	VAD.small.train
grave	VAD.small.train
great disgust	VAD.small.train
greatest	VAD.small.train
grenade	VAD.small.train
grounding	VAD.small.train
grrr	VAD.small.train
grumpy	VAD.small.train
grunt	VAD.small.train
grunting	VAD.small.train
guarantee	VAD.small.train
guardhouse	VAD.small.train
gurney	VAD.small.train
habitat	VAD.small.train
habitation	VAD.small.train
hall	VAD.small.train
hammerhead	VAD.small.train
hamster	VAD.small.train
handmade	VAD.small.train
hanger	VAD.small.train
hangout	VAD.small.train
harbor	VAD.small.train
harm	VAD.small.train
harness	VAD.small.train
hate	VAD.small.train
hazmat	VAD.small.train
healing	VAD.small.train
hear	VAD.small.train
heavens	VAD.small.train
heed	VAD.small.train
heirs	VAD.small.train
hemorrhage	VAD.small.train
hemostat	VAD.small.train
heretical	VAD.small.train
hero	VAD.small.train
hesitant	VAD.small.train
hex	VAD.small.train
hierarchical	VAD.small.train
hippopotamus	VAD.small.train
historic	VAD.small.train
hobo	VAD.small.train
hock	VAD.small.train
hohoho	VAD.small.train
holidays	VAD.small.train
hollow	VAD.small.train
holster	VAD.small.train
holy	VAD.small.train
home	VAD.small.train
homework	VAD.small.train
homicidal	VAD.small.train
hope	VAD.small.train
horizon	VAD.small.train
horizontal	VAD.small.train
horseback	VAD.small.train
hosiery	VAD.small.train
hospitality	VAD.small.train
hotshot	VAD.small.train
hourly	VAD.small.train
hue	VAD.small.train
hugger	VAD.small.train
hum	VAD.small.train
humbug	VAD.small.train
humorous	VAD.small.train
hurricane	VAD.small.train
hurt	VAD.small.train
hyperbole	VAD.small.train
hypertension	VAD.small.train
hypertrophy	VAD.small.train
hypochondriac	VAD.small.train
hypothermia	VAD.small.train
hypothesis	VAD.small.train
ibuprofen	VAD.small.train
ice	VAD.small.train
icy	VAD.small.train
idea	VAD.small.train
idle	VAD.small.train
idler	VAD.small.train
ignore	VAD.small.train
imagination	VAD.small.train
imagine	VAD.small.train
immature	VAD.small.train
immerse	VAD.small.train
imminent	VAD.small.train
immutable	VAD.small.train
imp	VAD.small.train
impartial	VAD.small.train
impassioned	VAD.small.train
impeach	VAD.small.train
implacable	VAD.small.train
implanted	VAD.small.train
impossibility	VAD.small.train
improvise	VAD.small.train
imputation	VAD.small.train
inadequate	VAD.small.train
inaffable	VAD.small.train
inattention	VAD.small.train
incomparable	VAD.small.train
inconsequential	VAD.small.train
incursion	VAD.small.train
indicator	VAD.small.train
indolent	VAD.small.train
inducement	VAD.small.train
inertia	VAD.small.train
infamous	VAD.small.train
infanticide	VAD.small.train
infectious	VAD.small.train
infinitely	VAD.small.train
inform	VAD.small.train
ingot	VAD.small.train
inhabiting	VAD.small.train
inhibition	VAD.small.train
inhuman	VAD.small.train
iniquity	VAD.small.train
injection	VAD.small.train
injustice	VAD.small.train
innumerable	VAD.small.train
inside	VAD.small.train
inspire	VAD.small.train
instantaneously	VAD.small.train
instrumentalist	VAD.small.train
insufferable	VAD.small.train
intellectual	VAD.small.train
intensify	VAD.small.train
intercede	VAD.small.train
intercept	VAD.small.train
interfere	VAD.small.train
interlocutory	VAD.small.train
internal	VAD.small.train
internship	VAD.small.train
interrogation	VAD.small.train
interview	VAD.small.train
intestine	VAD.small.train
intestines	VAD.small.train
intriguing	VAD.small.train
intrinsically	VAD.small.train
invasion	VAD.small.train
invasive	VAD.small.train
invent	VAD.small.train
inversion	VAD.small.train
investigator	VAD.small.train
irks	VAD.small.train
iron	VAD.small.train
irrefutable	VAD.small.train
irritable	VAD.small.train
isle	VAD.small.train
itchy	VAD.small.train
jammer	VAD.small.train
jellyfish	VAD.small.train
jiggle	VAD.small.train
jock	VAD.small.train
jugular	VAD.small.train
karmic	VAD.small.train
keep	VAD.small.train
keyboard	VAD.small.train
keystone	VAD.small.train
king	VAD.small.train
knockoff	VAD.small.train
lac	VAD.small.train
lactose	VAD.small.train
laddie	VAD.small.train
lagging	VAD.small.train
laptop	VAD.small.train
launches	VAD.small.train
lawyer	VAD.small.train
layman	VAD.small.train
leadership	VAD.small.train
leeway	VAD.small.train
legendary	VAD.small.train
legislate	VAD.small.train
legislation	VAD.small.train
legitimate	VAD.small.train
legume	VAD.small.train
leper	VAD.small.train
leprosy	VAD.small.train
lesion	VAD.small.train
lessee	VAD.small.train
lessen	VAD.small.train
lettuce	VAD.small.train
lewd	VAD.small.train
libel	VAD.small.train
license	VAD.small.train
light year	VAD.small.train
likable	VAD.small.train
likeness	VAD.small.train
limp	VAD.small.train
linguistics	VAD.small.train
lipstick	VAD.small.train
liquidation	VAD.small.train
literal	VAD.small.train
litigation	VAD.small.train
littlethings	VAD.small.train
localization	VAD.small.train
locator	VAD.small.train
locksmith	VAD.small.train
loon	VAD.small.train
loony	VAD.small.train
loophole	VAD.small.train
lopsided	VAD.small.train
loser	VAD.small.train
lousy	VAD.small.train
loved	VAD.small.train
lovelife	VAD.small.train
lowlife	VAD.small.train
lox	VAD.small.train
lubricant	VAD.small.train
lubrication	VAD.small.train
lusty	VAD.small.train
luxuriant	VAD.small.train
macadamia	VAD.small.train
magistrate	VAD.small.train
magnificence	VAD.small.train
mainland	VAD.small.train
malformation	VAD.small.train
malnutrition	VAD.small.train
mama	VAD.small.train
mambo	VAD.small.train
maneuver	VAD.small.train
mange	VAD.small.train
mangle	VAD.small.train
manhood	VAD.small.train
manipulation	VAD.small.train
manna	VAD.small.train
manual	VAD.small.train
manufacture	VAD.small.train
mark	VAD.small.train
marked	VAD.small.train
marker	VAD.small.train
marksmanship	VAD.small.train
maroon	VAD.small.train
martini	VAD.small.train
masculinity	VAD.small.train
massage	VAD.small.train
masterful	VAD.small.train
matting	VAD.small.train
mean	VAD.small.train
membrane	VAD.small.train
memorandum	VAD.small.train
memories	VAD.small.train
merit	VAD.small.train
mescaline	VAD.small.train
meticulous	VAD.small.train
metrology	VAD.small.train
micron	VAD.small.train
midland	VAD.small.train
milestone	VAD.small.train
mimicry	VAD.small.train
minded	VAD.small.train
miracle	VAD.small.train
miracles	VAD.small.train
misbehave	VAD.small.train
miscalculation	VAD.small.train
miserably	VAD.small.train
misery	VAD.small.train
mislead	VAD.small.train
mismatched	VAD.small.train
mission	VAD.small.train
mix	VAD.small.train
mocked	VAD.small.train
mockery	VAD.small.train
mocking	VAD.small.train
moderately	VAD.small.train
mogul	VAD.small.train
moisture	VAD.small.train
mole	VAD.small.train
molest	VAD.small.train
momma	VAD.small.train
mommy	VAD.small.train
monarch	VAD.small.train
monarchy	VAD.small.train
monkey	VAD.small.train
monogrammed	VAD.small.train
morph	VAD.small.train
mote	VAD.small.train
motivational	VAD.small.train
mouthwash	VAD.small.train
mozzarella	VAD.small.train
multinational	VAD.small.train
mummy	VAD.small.train
mundane	VAD.small.train
municipal	VAD.small.train
murderous	VAD.small.train
muscle	VAD.small.train
museum	VAD.small.train
mutable	VAD.small.train
mutton	VAD.small.train
mysterious	VAD.small.train
mystic	VAD.small.train
naught	VAD.small.train
nectar	VAD.small.train
negligee	VAD.small.train
negotiator	VAD.small.train
nerdy	VAD.small.train
networking	VAD.small.train
neurological	VAD.small.train
new	VAD.small.train
newcomer	VAD.small.train
newday	VAD.small.train
newscaster	VAD.small.train
nice	VAD.small.train
nickname	VAD.small.train
nightfall	VAD.small.train
nineteen	VAD.small.train
nitro	VAD.small.train
nitrogen	VAD.small.train
nobleman	VAD.small.train
nominee	VAD.small.train
nonfiction	VAD.small.train
nonresident	VAD.small.train
nonsense	VAD.small.train
noose	VAD.small.train
normality	VAD.small.train
northern	VAD.small.train
nosey	VAD.small.train
notification	VAD.small.train
numerous	VAD.small.train
nunnery	VAD.small.train
nut	VAD.small.train
nutcase	VAD.small.train
nutcracker	VAD.small.train
nutritious	VAD.small.train
obesity	VAD.small.train
object	VAD.small.train
oblique	VAD.small.train
ocarina	VAD.small.train
occupant	VAD.small.train
ocean	VAD.small.train
ode	VAD.small.train
odor	VAD.small.train
oestrogen	VAD.small.train
offer	VAD.small.train
official	VAD.small.train
offspring	VAD.small.train
omen	VAD.small.train
omitted	VAD.small.train
opaque	VAD.small.train
open	VAD.small.train
opener	VAD.small.train
opinion	VAD.small.train
orb	VAD.small.train
orbs	VAD.small.train
ordination	VAD.small.train
organ	VAD.small.train
organist	VAD.small.train
organize	VAD.small.train
oscillating	VAD.small.train
oust	VAD.small.train
outback	VAD.small.train
outpatient	VAD.small.train
overcrowded	VAD.small.train
overdose	VAD.small.train
overheated	VAD.small.train
overpriced	VAD.small.train
overrated	VAD.small.train
overreact	VAD.small.train
oversized	VAD.small.train
overthinking	VAD.small.train
overtired	VAD.small.train
overturn	VAD.small.train
pacemaker	VAD.small.train
pacified	VAD.small.train
padding	VAD.small.train
paddy	VAD.small.train
paganism	VAD.small.train
pained	VAD.small.train
paltry	VAD.small.train
paperwork	VAD.small.train
paragon	VAD.small.train
paralyze	VAD.small.train
paralyzed	VAD.small.train
parched	VAD.small.train
parental	VAD.small.train
parish	VAD.small.train
parity	VAD.small.train
park	VAD.small.train
parrot	VAD.small.train
partake	VAD.small.train
partisan	VAD.small.train
partly	VAD.small.train
passing	VAD.small.train
pastime	VAD.small.train
pasture	VAD.small.train
patriotic	VAD.small.train
pave	VAD.small.train
pawnshop	VAD.small.train
payroll	VAD.small.train
pea	VAD.small.train
peas	VAD.small.train
peddle	VAD.small.train
pedometer	VAD.small.train
pellet	VAD.small.train
pentagon	VAD.small.train
people	VAD.small.train
peptic	VAD.small.train
perceive	VAD.small.train
perdition	VAD.small.train
peripheral	VAD.small.train
periphery	VAD.small.train
perishing	VAD.small.train
perjury	VAD.small.train
perky	VAD.small.train
permeable	VAD.small.train
perplexity	VAD.small.train
persistent	VAD.small.train
perspective	VAD.small.train
perverted	VAD.small.train
pet	VAD.small.train
petunia	VAD.small.train
phone	VAD.small.train
photograph	VAD.small.train
photon	VAD.small.train
physical therapist	VAD.small.train
pickle	VAD.small.train
pickup	VAD.small.train
pimple	VAD.small.train
pinnacle	VAD.small.train
pisser	VAD.small.train
pissesmeoff	VAD.small.train
plaque	VAD.small.train
plasma	VAD.small.train
platform	VAD.small.train
platonic	VAD.small.train
playful	VAD.small.train
pleasurable	VAD.small.train
pleasures	VAD.small.train
pledge	VAD.small.train
pledged	VAD.small.train
plentiful	VAD.small.train
plication	VAD.small.train
plurality	VAD.small.train
poisoned	VAD.small.train
polygonal	VAD.small.train
pontoon	VAD.small.train
portage	VAD.small.train
porthole	VAD.small.train
positively	VAD.small.train
possess	VAD.small.train
postulate	VAD.small.train
pot	VAD.small.train
potency	VAD.small.train
pottery	VAD.small.train
potty	VAD.small.train
pound	VAD.small.train
practice	VAD.small.train
praised	VAD.small.train
precedent	VAD.small.train
preclude	VAD.small.train
precursor	VAD.small.train
predator	VAD.small.train
predict	VAD.small.train
predictable	VAD.small.train
predominate	VAD.small.train
preferential	VAD.small.train
prefix	VAD.small.train
pregnancy	VAD.small.train
prejudicial	VAD.small.train
premier	VAD.small.train
prenatal	VAD.small.train
prepared	VAD.small.train
preposterous	VAD.small.train
prerogative	VAD.small.train
presumption	VAD.small.train
prevail	VAD.small.train
previously	VAD.small.train
priestly	VAD.small.train
priory	VAD.small.train
prism	VAD.small.train
pristine	VAD.small.train
proctologist	VAD.small.train
procure	VAD.small.train
profile	VAD.small.train
projectile	VAD.small.train
prolong	VAD.small.train
promising	VAD.small.train
pronounce	VAD.small.train
prop	VAD.small.train
propane	VAD.small.train
propelled	VAD.small.train
proper	VAD.small.train
prosecute	VAD.small.train
prospect	VAD.small.train
prosper	VAD.small.train
protagonist	VAD.small.train
protest	VAD.small.train
protocol	VAD.small.train
province	VAD.small.train
provision	VAD.small.train
provisionally	VAD.small.train
provoke	VAD.small.train
psi	VAD.small.train
psoriasis	VAD.small.train
psychiatric	VAD.small.train
psychiatrist	VAD.small.train
pubic	VAD.small.train
pull	VAD.small.train
pulp	VAD.small.train
punctually	VAD.small.train
punitive	VAD.small.train
purchase	VAD.small.train
pursuance	VAD.small.train
purveyor	VAD.small.train
push	VAD.small.train
putter	VAD.small.train
puzzle	VAD.small.train
quadrant	VAD.small.train
quadrupole	VAD.small.train
quake	VAD.small.train
qualifying	VAD.small.train
queasy	VAD.small.train
quickness	VAD.small.train
quotation	VAD.small.train
racist	VAD.small.train
radon	VAD.small.train
rainbow trout	VAD.small.train
rainmaker	VAD.small.train
rambling	VAD.small.train
rancher	VAD.small.train
rap	VAD.small.train
raptor	VAD.small.train
read	VAD.small.train
reassignment	VAD.small.train
reboot	VAD.small.train
rebuild	VAD.small.train
receive	VAD.small.train
receptionist	VAD.small.train
recession	VAD.small.train
recherche	VAD.small.train
reciprocate	VAD.small.train
recompense	VAD.small.train
reconnect	VAD.small.train
recoup	VAD.small.train
recruit	VAD.small.train
recruiter	VAD.small.train
recycle	VAD.small.train
redhead	VAD.small.train
reduced	VAD.small.train
reek	VAD.small.train
reentry	VAD.small.train
reformation	VAD.small.train
refraction	VAD.small.train
refreshment	VAD.small.train
refrigerator	VAD.small.train
refusing	VAD.small.train
refute	VAD.small.train
regeneration	VAD.small.train
regionalism	VAD.small.train
registry	VAD.small.train
regretted	VAD.small.train
regretting	VAD.small.train
regular	VAD.small.train
regulation	VAD.small.train
relight	VAD.small.train
remainder	VAD.small.train
remake	VAD.small.train
remedial	VAD.small.train
reminiscent	VAD.small.train
remiss	VAD.small.train
remodel	VAD.small.train
remote	VAD.small.train
renown	VAD.small.train
replace	VAD.small.train
reported	VAD.small.train
reprisal	VAD.small.train
republic	VAD.small.train
required	VAD.small.train
researcher	VAD.small.train
resembling	VAD.small.train
resentment	VAD.small.train
resigned	VAD.small.train
resonant	VAD.small.train
respite	VAD.small.train
respond	VAD.small.train
responsible	VAD.small.train
restoration	VAD.small.train
restore	VAD.small.train
retaliatory	VAD.small.train
rethink	VAD.small.train
retold	VAD.small.train
retract	VAD.small.train
retrieval	VAD.small.train
retroactive	VAD.small.train
reunite	VAD.small.train
revels	VAD.small.train
revue	VAD.small.train
rewire	VAD.small.train
rhapsody	VAD.small.train
rhubarb	VAD.small.train
rigged	VAD.small.train
rioting	VAD.small.train
robotic	VAD.small.train
roommate	VAD.small.train
rope	VAD.small.train
ruckus	VAD.small.train
ruff	VAD.small.train
rule	VAD.small.train
rumba	VAD.small.train
runt	VAD.small.train
rusted	VAD.small.train
sacrificial	VAD.small.train
sad	VAD.small.train
sadly	VAD.small.train
safety	VAD.small.train
salad	VAD.small.train
sally	VAD.small.train
salsa	VAD.small.train
saltwater	VAD.small.train
salvage	VAD.small.train
sample	VAD.small.train
sanctioned	VAD.small.train
sanctity	VAD.small.train
sandpaper	VAD.small.train
sausage	VAD.small.train
savage	VAD.small.train
saver	VAD.small.train
savings	VAD.small.train
sayonara	VAD.small.train
scene	VAD.small.train
scent	VAD.small.train
science	VAD.small.train
scientist	VAD.small.train
scion	VAD.small.train
scoundrel	VAD.small.train
scout	VAD.small.train
scrappy	VAD.small.train
screw	VAD.small.train
sculptor	VAD.small.train
seamstress	VAD.small.train
searchlight	VAD.small.train
sectarian	VAD.small.train
section	VAD.small.train
sectional	VAD.small.train
sector	VAD.small.train
see	VAD.small.train
selflove	VAD.small.train
semaphore	VAD.small.train
send	VAD.small.train
separatist	VAD.small.train
sepia	VAD.small.train
serenade	VAD.small.train
setback	VAD.small.train
setup	VAD.small.train
seventeen	VAD.small.train
shadowy	VAD.small.train
shallow	VAD.small.train
shaving	VAD.small.train
sheer	VAD.small.train
shitday	VAD.small.train
shiver	VAD.small.train
shoelace	VAD.small.train
shorts	VAD.small.train
shot	VAD.small.train
showbiz	VAD.small.train
shower	VAD.small.train
shrivel	VAD.small.train
shrunken	VAD.small.train
side	VAD.small.train
sideburns	VAD.small.train
sidewinder	VAD.small.train
sign	VAD.small.train
significance	VAD.small.train
signification	VAD.small.train
silent	VAD.small.train
silk	VAD.small.train
silliness	VAD.small.train
silvery	VAD.small.train
similar	VAD.small.train
simmer	VAD.small.train
simplistic	VAD.small.train
sinking	VAD.small.train
siren	VAD.small.train
skateboard	VAD.small.train
skiff	VAD.small.train
skirt	VAD.small.train
slanderous	VAD.small.train
slashes	VAD.small.train
sled	VAD.small.train
sleeper	VAD.small.train
sleepover	VAD.small.train
sleet	VAD.small.train
slight surprise	VAD.small.train
slightly negative	VAD.small.train
slough	VAD.small.train
smart	VAD.small.train
snakes	VAD.small.train
snakeskin	VAD.small.train
sneaky	VAD.small.train
snoop	VAD.small.train
snowman	VAD.small.train
snub	VAD.small.train
social	VAD.small.train
sod	VAD.small.train
soil	VAD.small.train
soiree	VAD.small.train
solidified	VAD.small.train
solve	VAD.small.train
somethingigetalot	VAD.small.train
soprano	VAD.small.train
soready	VAD.small.train
sorghum	VAD.small.train
sorrow	VAD.small.train
sou	VAD.small.train
soulmate	VAD.small.train
sourpuss	VAD.small.train
south	VAD.small.train
southern	VAD.small.train
spatter	VAD.small.train
speaker	VAD.small.train
speckled	VAD.small.train
spectacular	VAD.small.train
spender	VAD.small.train
spinning	VAD.small.train
spinster	VAD.small.train
split	VAD.small.train
spokesman	VAD.small.train
sponge	VAD.small.train
spontaneity	VAD.small.train
spotted	VAD.small.train
spotter	VAD.small.train
spout	VAD.small.train
squash	VAD.small.train
standard	VAD.small.train
standpoint	VAD.small.train
starboard	VAD.small.train
starlight	VAD.small.train
stars	VAD.small.train
start	VAD.small.train
starter	VAD.small.train
starving	VAD.small.train
static	VAD.small.train
steal	VAD.small.train
steamroller	VAD.small.train
steps	VAD.small.train
sterility	VAD.small.train
sterling	VAD.small.train
sternum	VAD.small.train
steroid	VAD.small.train
steward	VAD.small.train
stfu	VAD.small.train
stickler	VAD.small.train
stinger	VAD.small.train
stink	VAD.small.train
stinking	VAD.small.train
stipulation	VAD.small.train
stockade	VAD.small.train
stocking	VAD.small.train
stony	VAD.small.train
stools	VAD.small.train
stoppage	VAD.small.train
storm	VAD.small.train
storybook	VAD.small.train
strangle	VAD.small.train
strangulation	VAD.small.train
strapless	VAD.small.train
streamer	VAD.small.train
strength	VAD.small.train
stressed	VAD.small.train
stressin	VAD.small.train
strip	VAD.small.train
striptease	VAD.small.train
stub	VAD.small.train
stun	VAD.small.train
stunning	VAD.small.train
stunted	VAD.small.train
stupendous	VAD.small.train
submission	VAD.small.train
submissive	VAD.small.train
subsidiary	VAD.small.train
subtype	VAD.small.train
succession	VAD.small.train
sudden	VAD.small.train
suds	VAD.small.train
suffocating	VAD.small.train
suffocation	VAD.small.train
sum	VAD.small.train
summarize	VAD.small.train
summerhouse	VAD.small.train
summit	VAD.small.train
summons	VAD.small.train
sunday	VAD.small.train
sundown	VAD.small.train
superimposed	VAD.small.train
supply	VAD.small.train
supported	VAD.small.train
supremacy	VAD.small.train
surgeon	VAD.small.train
surprises	VAD.small.train
surrounding	VAD.small.train
survival	VAD.small.train
swag	VAD.small.train
swap	VAD.small.train
sweater	VAD.small.train
sweating	VAD.small.train
sweeping	VAD.small.train
sweeten	VAD.small.train
swelling	VAD.small.train
swift	VAD.small.train
swing	VAD.small.train
swipe	VAD.small.train
switch	VAD.small.train
syndrome	VAD.small.train
tailpipe	VAD.small.train
tallies	VAD.small.train
tang	VAD.small.train
tape	VAD.small.train
tariff	VAD.small.train
tarry	VAD.small.train
tartar	VAD.small.train
tasting	VAD.small.train
taupe	VAD.small.train
tavern	VAD.small.train
tech	VAD.small.train
technicality	VAD.small.train
technique	VAD.small.train
ted	VAD.small.train
temperamental	VAD.small.train
temperature	VAD.small.train
tempo	VAD.small.train
temptation	VAD.small.train
tenable	VAD.small.train
tense	VAD.small.train
tent	VAD.small.train
tenths	VAD.small.train
terminal	VAD.small.train
terminology	VAD.small.train
terms	VAD.small.train
terrified	VAD.small.train
terrorize	VAD.small.train
tether	VAD.small.train
tgif	VAD.small.train
thebest	VAD.small.train
theism	VAD.small.train
theocracy	VAD.small.train
therapy	VAD.small.train
thermal	VAD.small.train
thicken	VAD.small.train
thickness	VAD.small.train
thirteen	VAD.small.train
thirty	VAD.small.train
thistle	VAD.small.train
thorn	VAD.small.train
thousand	VAD.small.train
threatened	VAD.small.train
throwback	VAD.small.train
thrush	VAD.small.train
thud	VAD.small.train
tickle	VAD.small.train
tightness	VAD.small.train
toe	VAD.small.train
toffee	VAD.small.train
toot	VAD.small.train
top	VAD.small.train
topside	VAD.small.train
tough	VAD.small.train
towel	VAD.small.train
townspeople	VAD.small.train
tragedy	VAD.small.train
tranquility	VAD.small.train
transact	VAD.small.train
transcendental	VAD.small.train
translator	VAD.small.train
transparent	VAD.small.train
transponder	VAD.small.train
trappings	VAD.small.train
trek	VAD.small.train
trembling	VAD.small.train
trend	VAD.small.train
triad	VAD.small.train
trident	VAD.small.train
trolley	VAD.small.train
troubles	VAD.small.train
troublesome	VAD.small.train
trundle	VAD.small.train
tube	VAD.small.train
tufted	VAD.small.train
turbo	VAD.small.train
turnip	VAD.small.train
turnover	VAD.small.train
tussle	VAD.small.train
twats	VAD.small.train
tweet	VAD.small.train
twelve	VAD.small.train
twilight	VAD.small.train
twister	VAD.small.train
typhoid	VAD.small.train
ugly	VAD.small.train
unable	VAD.small.train
unbeatable	VAD.small.train
unbeaten	VAD.small.train
uncanny	VAD.small.train
uncertain	VAD.small.train
uncommonly	VAD.small.train
uncontrollable	VAD.small.train
uncooked	VAD.small.train
uncouth	VAD.small.train
uncut	VAD.small.train
underage	VAD.small.train
underlay	VAD.small.train
understaffed	VAD.small.train
understatement	VAD.small.train
undesired	VAD.small.train
undeveloped	VAD.small.train
undisputed	VAD.small.train
undue	VAD.small.train
unencumbered	VAD.small.train
unending	VAD.small.train
unfettered	VAD.small.train
unflinching	VAD.small.train
unfortunate	VAD.small.train
unfurnished	VAD.small.train
unguarded	VAD.small.train
unhook	VAD.small.train
unimpressed	VAD.small.train
unintentionally	VAD.small.train
unitary	VAD.small.train
universe	VAD.small.train
unlock	VAD.small.train
unnecessary	VAD.small.train
unneeded	VAD.small.train
unobtrusive	VAD.small.train
unopposed	VAD.small.train
unrecorded	VAD.small.train
unresponsive	VAD.small.train
unrestrained	VAD.small.train
untimely	VAD.small.train
untold	VAD.small.train
unturned	VAD.small.train
unutterable	VAD.small.train
unwary	VAD.small.train
unwillingness	VAD.small.train
upshot	VAD.small.train
urn	VAD.small.train
usefulness	VAD.small.train
utter	VAD.small.train
utterance	VAD.small.train
vacancy	VAD.small.train
vaccination	VAD.small.train
validity	VAD.small.train
valuation	VAD.small.train
vampire	VAD.small.train
vary	VAD.small.train
vase	VAD.small.train
velvety	VAD.small.train
vengeful	VAD.small.train
venture	VAD.small.train
verb	VAD.small.train
verbosity	VAD.small.train
veritable	VAD.small.train
vestige	VAD.small.train
veterinary	VAD.small.train
victor	VAD.small.train
vie	VAD.small.train
viewpoint	VAD.small.train
villain	VAD.small.train
violin	VAD.small.train
viral	VAD.small.train
visa	VAD.small.train
visibility	VAD.small.train
visitation	VAD.small.train
vocalist	VAD.small.train
volunteering	VAD.small.train
voting	VAD.small.train
wade	VAD.small.train
walking	VAD.small.train
wallpaper	VAD.small.train
wannabe	VAD.small.train
warp	VAD.small.train
washroom	VAD.small.train
wasting	VAD.small.train
way	VAD.small.train
weakened	VAD.small.train
weakly	VAD.small.train
weapon	VAD.small.train
wearily	VAD.small.train
weekday	VAD.small.train
weenie	VAD.small.train
welsh	VAD.small.train
wheelbarrow	VAD.small.train
whimper	VAD.small.train
whimsy	VAD.small.train
whip	VAD.small.train
whiskers	VAD.small.train
whispered	VAD.small.train
whopping	VAD.small.train
wickedness	VAD.small.train
widen	VAD.small.train
widowed	VAD.small.train
wily	VAD.small.train
win	VAD.small.train
wince	VAD.small.train
winner	VAD.small.train
wintry	VAD.small.train
wisdom	VAD.small.train
wistful	VAD.small.train
wit	VAD.small.train
withdrawn	VAD.small.train
withstand	VAD.small.train
woodlands	VAD.small.train
workup	VAD.small.train
worldly	VAD.small.train
worm	VAD.small.train
worn	VAD.small.train
worrying	VAD.small.train
wot	VAD.small.train
wrist	VAD.small.train
wrong	VAD.small.train
yaaaay	VAD.small.train
yachting	VAD.small.train
yard	VAD.small.train
yawning	VAD.small.train
yearn	VAD.small.train
yeller	VAD.small.train
yen	VAD.small.train
yesss	VAD.small.train
yon	VAD.small.train
yousuck	VAD.small.train
zephyr	VAD.small.train
Word	VAD.small.val
abandonment	VAD.small.val
accessory	VAD.small.val
adipose	VAD.small.val
adjudicate	VAD.small.val
alphabetical	VAD.small.val
ambitious	VAD.small.val
ample	VAD.small.val
anointing	VAD.small.val
apache	VAD.small.val
aristocrat	VAD.small.val
army	VAD.small.val
assessment	VAD.small.val
assign	VAD.small.val
astronomer	VAD.small.val
attempt	VAD.small.val
availability	VAD.small.val
bail	VAD.small.val
beholder	VAD.small.val
bellman	VAD.small.val
berserk	VAD.small.val
bidder	VAD.small.val
blower	VAD.small.val
bong	VAD.small.val
brainstorm	VAD.small.val
broth	VAD.small.val
butane	VAD.small.val
buttermilk	VAD.small.val
buttock	VAD.small.val
calendar	VAD.small.val
cave	VAD.small.val
ceramics	VAD.small.val
cheek	VAD.small.val
chin	VAD.small.val
cilantro	VAD.small.val
clue	VAD.small.val
coherence	VAD.small.val
coldness	VAD.small.val
colic	VAD.small.val
collarbone	VAD.small.val
combo	VAD.small.val
committal	VAD.small.val
concatenation	VAD.small.val
congress	VAD.small.val
contour	VAD.small.val
correlative	VAD.small.val
credentials	VAD.small.val
crest	VAD.small.val
cringe	VAD.small.val
crucifixion	VAD.small.val
crushing	VAD.small.val
curtains	VAD.small.val
cushy	VAD.small.val
cutter	VAD.small.val
daybreak	VAD.small.val
dazzling	VAD.small.val
debacle	VAD.small.val
defection	VAD.small.val
detritus	VAD.small.val
developing	VAD.small.val
deviate	VAD.small.val
devoid	VAD.small.val
direct	VAD.small.val
discussion	VAD.small.val
dude	VAD.small.val
dustpan	VAD.small.val
empress	VAD.small.val
equator	VAD.small.val
etiquette	VAD.small.val
excel	VAD.small.val
expansion	VAD.small.val
fertility	VAD.small.val
flipping	VAD.small.val
flirty	VAD.small.val
flour	VAD.small.val
freshen	VAD.small.val
frighten	VAD.small.val
gait	VAD.small.val
gator	VAD.small.val
geography	VAD.small.val
german	VAD.small.val
germane	VAD.small.val
girl	VAD.small.val
glacial	VAD.small.val
gusty	VAD.small.val
hairdryer	VAD.small.val
hallmark	VAD.small.val
hard	VAD.small.val
heartsick	VAD.small.val
hight	VAD.small.val
hillside	VAD.small.val
hold	VAD.small.val
hosannah	VAD.small.val
hurl	VAD.small.val
hushed	VAD.small.val
hyena	VAD.small.val
implication	VAD.small.val
inanimate	VAD.small.val
incredible	VAD.small.val
injuring	VAD.small.val
insecure	VAD.small.val
interferometer	VAD.small.val
intricate	VAD.small.val
introduction	VAD.small.val
irrigate	VAD.small.val
jazzy	VAD.small.val
jiffy	VAD.small.val
jump rope	VAD.small.val
kaput	VAD.small.val
keyhole	VAD.small.val
knack	VAD.small.val
knee	VAD.small.val
knowledge	VAD.small.val
kris	VAD.small.val
landfall	VAD.small.val
lash	VAD.small.val
lasting	VAD.small.val
latch	VAD.small.val
lather	VAD.small.val
laxative	VAD.small.val
leopard	VAD.small.val
ley	VAD.small.val
listenting	VAD.small.val
lute	VAD.small.val
maniac	VAD.small.val
match	VAD.small.val
micrometer	VAD.small.val
monastery	VAD.small.val
mouthpiece	VAD.small.val
musk	VAD.small.val
negative	VAD.small.val
neutralize	VAD.small.val
nix	VAD.small.val
notional	VAD.small.val
obstetrics	VAD.small.val
op	VAD.small.val
orator	VAD.small.val
painfully	VAD.small.val
palsy	VAD.small.val
parsimonious	VAD.small.val
penance	VAD.small.val
pendant	VAD.small.val
pessimistic	VAD.small.val
petulant	VAD.small.val
pie	VAD.small.val
plunge	VAD.small.val
poet	VAD.small.val
preview	VAD.small.val
prong	VAD.small.val
protein	VAD.small.val
pseudonym	VAD.small.val
quicken	VAD.small.val
ravioli	VAD.small.val
recruiting	VAD.small.val
redheaded	VAD.small.val
regal	VAD.small.val
remove	VAD.small.val
replenish	VAD.small.val
reputation	VAD.small.val
residence	VAD.small.val
restrictive	VAD.small.val
retentive	VAD.small.val
riff	VAD.small.val
rift	VAD.small.val
riveted	VAD.small.val
rump	VAD.small.val
saxophone	VAD.small.val
scrabble	VAD.small.val
seashore	VAD.small.val
senator	VAD.small.val
shackle	VAD.small.val
shortage	VAD.small.val
shorten	VAD.small.val
shove	VAD.small.val
silhouette	VAD.small.val
simmering	VAD.small.val
sizable	VAD.small.val
slaughterhouse	VAD.small.val
stalemate	VAD.small.val
stamina	VAD.small.val
sugar	VAD.small.val
superb	VAD.small.val
superficial	VAD.small.val
superposition	VAD.small.val
survive	VAD.small.val
suspension	VAD.small.val
swine	VAD.small.val
tangent	VAD.small.val
taxi	VAD.small.val
thermos	VAD.small.val
thong	VAD.small.val
ticklish	VAD.small.val
timid	VAD.small.val
trailer	VAD.small.val
tribune	VAD.small.val
truncate	VAD.small.val
unbound	VAD.small.val
undead	VAD.small.val
undefined	VAD.small.val
unfavorable	VAD.small.val
unregistered	VAD.small.val
uppercut	VAD.small.val
vegetable	VAD.small.val
visible	VAD.small.val
wherewithal	VAD.small.val
wipe	VAD.small.val
wrenching	VAD.small.val
yawn	VAD.small.val
